Vietnam Airlines-HAN-SGN|Vietnam Airlines|HAN|SGN
Vietjet Air-SGN-HAN|Vietjet Air|SGN|HAN
Bamboo Airways-DAD-SGN|Bamboo Airways|DAD|SGN
Vietnam Airlines-SGN-DAD|Vietnam Airlines|SGN|DAD
Pacific Airlines-HAN-CXR|Pacific Airlines|HAN|CXR
Vietjet Air-PQC-SGN|Vietjet Air|PQC|SGN
Bamboo Airways-SGN-HUI|Bamboo Airways|SGN|HUI
Vietnam Airlines-CXR-HAN|Vietnam Airlines|CXR|HAN
Pacific Airlines-DAD-SGN|Pacific Airlines|DAD|SGN
Vietjet Air-SGN-CXR|Vietjet Air|SGN|CXR
Vietnam Airlines-DLI-SGN|Vietnam Airlines|DLI|SGN
Bamboo Airways-HAN-UIH|Bamboo Airways|HAN|UIH
Vietjet Air-SGN-THD|Vietjet Air|SGN|THD
Pacific Airlines-CXR-DAD|Pacific Airlines|CXR|DAD
Vietnam Airlines-HAN-DAD|Vietnam Airlines|HAN|DAD
Bamboo Airways-SGN-HPH|Bamboo Airways|SGN|HPH
Pacific Airlines-SGN-HAN|Pacific Airlines|SGN|HAN
Vietnam Airlines-HAN-CXR|Vietnam Airlines|HAN|CXR
Pacific Airlines-HAN-PQC|Pacific Airlines|HAN|PQC
Vietnam Airlines-SGN-HAN|Vietnam Airlines|SGN|HAN
Bamboo Airways-CXR-SGN|Bamboo Airways|CXR|SGN
Pacific Airlines-HAN-DAD|Pacific Airlines|HAN|DAD
Vietnam Airlines-DAD-HAN|Vietnam Airlines|DAD|HAN
Bamboo Airways-SGN-VCA|Bamboo Airways|SGN|VCA
Pacific Airlines-SGN-DAD|Pacific Airlines|SGN|DAD
Bamboo Airways-HAN-CXR|Bamboo Airways|HAN|CXR
Pacific Airlines-SGN-HUI|Pacific Airlines|SGN|HUI
Vietnam Airlines-PQC-HAN|Vietnam Airlines|PQC|HAN
Bamboo Airways-DAD-SGN|Bamboo Airways|DAD|SGN
Pacific Airlines-HAN-SGN|Pacific Airlines|HAN|SGN
Bamboo Airways-HAN-UIH|Bamboo Airways|HAN|UIH
Pacific Airlines-HAN-DAD|Pacific Airlines|HAN|DAD
Vietnam Airlines-CXR-SGN|Vietnam Airlines|CXR|SGN
Bamboo Airways-HAN-DAD|Bamboo Airways|HAN|DAD
Pacific Airlines-SGN-THD|Pacific Airlines|SGN|THD
Bamboo Airways-DAD-CXR|Bamboo Airways|DAD|CXR
Vietjet Air-HAN-SGN|Vietjet Air|HAN|SGN
Vietjet Air-SGN-DAD|Vietjet Air|SGN|DAD
