HAN-SGN|HAN|SGN
SGN-HAN|SGN|HAN
HAN-DAD|HAN|DAD
DAD-HAN|DAD|HAN
SGN-DAD|SGN|DAD
DAD-SGN|DAD|SGN
HAN-PQC|HAN|PQC
PQC-HAN|PQC|HAN
SGN-PQC|SGN|PQC
PQC-SGN|PQC|SGN
HAN-CXR|HAN|CXR
CXR-HAN|CXR|HAN
SGN-CXR|SGN|CXR
CXR-SGN|CXR|SGN
HAN-HPH|HAN|HPH
HPH-HAN|HPH|HAN
SGN-HPH|SGN|HPH
SGN-HUI|SGN|HUI
HUI-SGN|HUI|SGN
HAN-UIH|HAN|UIH
UIH-HAN|UIH|HAN
SGN-UIH|SGN|UIH
UIH-SGN|UIH|SGN
HAN-BMV|HAN|BMV
BMV-HAN|BMV|HAN
SGN-BMV|SGN|BMV
BMV-SGN|BMV|SGN
HAN-VCA|HAN|VCA
VCA-HAN|VCA|HAN
SGN-VCA|SGN|VCA
VCA-SGN|VCA|SGN
CAH-HUI|CAH|HUI
HPH-PQC|HPH|PQC
HUI-UIH|HUI|UIH
VCA-CXR|VCA|CXR
BKK-SGN|BKK|SGN
BKK-HUI|BKK|HUI
VCA-HUI|VCA|HUI
HAN-ICN|HAN|ICN
CXR-BKK|CXR|BKK
VCA-BKK|VCA|BKK
DAD-VCA|DAD|VCA
